MMMMMMMMMMMMMMMMMMMM
M        MMM    B  M
M        MOM   BTB M
M      MMMXMMM     M
M        XHXO   B  M
M      MMMXMMM     M
M      BTMOM       M
M         MM       M
MMMMMMMMMMMMMMMMMMMM
