MMMMMMMMMMMMMMMMMMMM
M        MMM       M
M        MOM       M
M      MMMXMMM     M
M      MOXHXOM     M
M      MMMXMMM     M
M        MOM       M
M        MMM       M
MMMMMMMMMMMMMMMMMMMM
