MMMMMMMMMMMMMMMMMMMM
M                  M
M                  M
M   MMCMMAMAMMM    M
M   MMHX     OM    M
M   MMMMAMAMMMM    M
M                  M
M                  M
MMMMMMMMMMMMMMMMMMMM
