MMMMMMMMMMMMMMMMMMMM
M                  M
M              H   M
M         RR       M
M          R       M
M        X RR      M
M              O   M
M                  M
MMMMMMMMMMMMMMMMMMMM
