MMMMMMMMMMMMMMMMMMMM
M                  M
M        MM        M
M                  M
M   O    H   B     M
M                  M
M    O  B  XXXX    M
M                  M
MMMMMMMMMMMMMMMMMMMM
