MMMMMMMMMMMMMMMMMMMM
M    B   MMM    B  M
M   BTB  MOM   BTB M
M      MMMXMMM     M
M  BB    XHXO   B  M
M      MMMXMMM     M
M  T   BTMOM    B  M
M    T    MM       M
MMMMMMMMMMMMMMMMMMMM
