MMMMMMMMMMMMMMMMMMMM
M                  M
M        B         M
M                  M
M   OB    H  OO    M
M                  M
M    O  B   X      M
M                  M
MMMMMMMMMMMMMMMMMMMM
