MMMMMMMMMMMMMMMMMMMM
M                  M
M    O   MM        M
M                  M
M   O    H   B     M
M                  M
M       B  X X     M
M                  M
MMMMMMMMMMMMMMMMMMMM
