MMMMMMMMMMMMMMMMMMMM
M                  M
M  O   B  G  O     M
M                  M
M  X G  X  H       M
M                  M
M    O  B   X      M
M                  M
MMMMMMMMMMMMMMMMMMMM
